外装	exterior
内装	Interior
前面	front
車内設備	in_car_equipment
車内設備mx	in_car_equipment_mx
貫通扉	through_door
幌	hood
ﾗﾝﾎﾞｰﾄﾞ	lambord
機器類	equipment
ケーブル	cable
運転台	cab
スカート	skirt1
スカート	skirt2
床下機器	Uf1
床下機器	Uf2
パンタグラフ	panta
ドア	door
半透明	alpha
ライトA	lightF
ライトB	lightB
